........
.###.#.#
.#...##.
##......
#...@...
###..###
.#...#.#
.#..##.#
