...###
.###.#.###
.#...##..#
##.......#
#...@....#
###..###.#
.#...#.#.#
.#..##.#.#
.#......##
.#.....##
.#######