#######
#...#.#
#.#.#.#
#.#.#.#
#.#@#.#
#.#.#.#
#.#.#.#
#.#.#.#
#.#.#.#
#.#...#
#######